############################
#.........##....##.........#
#.#######.##.##.##.#######.#
#O#######.##.##.##.#######O#
#.##.........##.........##.#
#.##.##.####.##.####.##.##.#
#....##.####.##.####.##....#
####.##.####.##.####.##.####
####.##..............##.####
X....#### ######## ####....X
#.## #### ######## #### ##.#
#.##                    ##.#
#.#### ## ######## ## ####.#
#.#### ## ######## ## ####.#
#.     ## ######## ##     .#
#.## #### ######## #### ##.#
#.## #### ######## #### ##.#
#.##                    ##.#
#.#### ##### ## ##### ####.#
#.#### ##### ## ##### ####.#
#......##....##....##......#
###.##.##.########.##.##.###
###.##.##.########.##.##.###
#O..##.......  .......##..O#
#.####.#####.##.#####.####.#
#.####.#####.##.#####.####.#
#......##....##....##......#
#.####.##.########.##.####.#
#.####.##.########.##.####.#
#......##..........##......#
############################
end